5 10
4 4 5 4 5 5 0 4 0 6
4 4 0 4 0 6 0 4 0 0
1 0 0 6 3 4 0 4 0 2
4 4 0 4 4 4 0 0 0 3
4 4 5 4 4 4 0 4 0 0
